 #####
## + #
#  * #
# $* #
#  * #
###  #
  ####